Months,Rent,Mobile,Gym,Groceries,Entertainment,Monthly Budget
January,265,15,10,220,120,630
February,265,15,10,240,90,620
March,265,15,10,210,150,650
April,265,15,10,200,110,600
May,265,15,10,250,100,640
June,265,15,10,220,90,600
July,265,15,15,240,120,655
August,265,20,15,230,115,645
September,265,20,15,250,95,645
October,265,20,20,280,85,670
November,275,20,20,260,100,675
